################################################################
#..............................................................#
#..............................................................#
#..............................................................#
#..............................................................#
#..............................................................#
#...........1111111111111111111111111111111111111111...........#
#..............................................................#
#..............................................................#
#..............................................................#
#..............................................................#
#..............................................................#
#..............................................................#
#..............................................................#
#..............................................................#
#..............................................................#
#..............................................................#
#..............................................................#
#..............................................................#
#..............................................................#
#..............................................................#
#..............................................................#
#..............................................................#
#..............................................................#
#..............................................................#
#..............................................................#
#..............................................................#
#..............................................................#
#..............................................................#
#..............................................................#
#..............................................................#
#11111111......................................................#
#.......1......................................................#
#.......1......................................................#
#.......1......................................................#
#.......1......................................................#
#.......1......................................................#
#.......1......................................................#
#.......1......................................................#
################################################################
